--- - - --- --- ---
 -  - - - - -   -..
 -  --- --  --  --.
 -  - - --  -   -..
 -  - - - - --- ---